images\tilemap.png 16 27 18 
32 32 

464 36 37 90 91 91 91 92 37 82 83 83 115 110 114 84 37 38 462 463 464 36 37 38 443 443 443 443 443 36 37 37 
464 36 37 144 145 145 145 146 37 109 110 110 110 110 110 111 37 38 462 442 464 36 37 41 10 10 10 10 10 42 37 37 
464 36 37 17 18 19 20 17 37 136 147 148 149 137 137 138 37 38 462 463 464 36 37 90 91 91 91 91 91 92 37 37 
464 36 37 71 45 46 47 44 37 90 126 127 128 91 91 92 37 38 462 442 464 36 37 117 118 118 118 118 118 119 37 37 
464 36 37 98 99 286 101 98 37 117 207 283 209 118 118 119 37 38 462 463 464 36 37 144 145 145 145 145 145 146 37 37 
464 36 14 64 64 64 64 64 15 144 96 118 95 145 145 146 37 38 462 442 464 36 37 18 19 19 19 19 19 20 37 37 
464 36 38 443 443 443 443 443 36 126 144 145 146 127 127 128 37 38 462 463 464 36 37 45 46 46 46 46 46 47 37 37 
464 36 38 464 464 464 464 464 36 153 126 127 128 154 154 155 37 38 462 442 464 36 37 387 388 389 286 387 388 389 37 37 
464 36 38 461 461 441 440 461 36 207 153 154 155 208 286 209 37 38 462 463 464 36 37 37 37 37 37 37 37 37 37 37 
464 36 41 10 11 462 464 9 42 37 207 208 209 37 37 37 37 38 462 442 464 36 37 37 37 37 37 37 37 37 37 37 
464 63 64 64 65 462 464 63 64 64 64 64 64 64 64 64 64 65 435 436 437 63 64 64 64 64 64 64 64 64 64 64 
467 406 407 407 407 468 467 407 407 407 407 407 407 407 407 407 407 407 468 442 467 407 407 406 407 407 407 406 407 407 407 407 
469 433 469 434 469 434 442 434 469 434 442 434 469 434 469 434 442 434 442 434 442 434 442 433 442 434 442 433 442 434 442 434 
440 460 461 461 461 461 461 461 461 461 461 461 461 461 461 461 461 461 461 461 461 461 461 460 441 442 440 460 461 461 461 0 
464 9 10 10 10 10 10 10 10 10 10 10 10 10 10 10 10 10 10 10 10 10 10 11 435 436 437 9 82 83 83 136 
464 36 37 37 37 37 37 37 37 37 37 37 37 37 37 37 91 92 37 37 37 37 37 38 462 442 464 36 136 137 137 126 
464 36 109 110 110 111 109 110 110 111 37 37 37 117 118 95 145 146 0 64 0 37 37 38 462 463 464 36 126 127 127 153 
464 36 136 137 137 138 136 137 137 138 37 37 37 117 118 119 181 182 29 29 29 37 37 38 462 442 464 36 207 208 208 180 
464 36 125 129 131 125 17 21 23 17 37 37 37 144 145 146 284 209 29 29 29 37 37 38 462 463 464 36 37 37 37 207 
464 36 206 284 212 206 71 48 50 71 37 37 37 180 181 182 29 29 29 29 29 37 37 38 462 442 464 36 37 37 37 37 
464 36 37 37 37 37 98 102 284 98 37 37 37 207 284 209 0 0 0 0 0 37 37 38 462 463 464 36 37 82 83 84 
464 36 37 37 37 37 37 37 37 37 37 37 37 37 37 37 37 37 37 37 37 37 37 38 462 442 464 36 37 136 137 138 
466 36 37 37 37 37 37 37 37 37 37 37 37 0 0 0 0 0 37 0 0 0 0 38 462 463 464 36 37 18 19 20 
10 42 37 37 37 2 2 2 2 2 2 2 37 136 137 137 137 138 37 117 118 119 151 38 462 442 464 36 37 99 100 284 
83 84 37 37 28 29 29 29 29 29 29 29 30 126 130 130 130 128 37 117 118 119 17 38 462 463 464 36 37 37 37 37 
110 111 37 37 28 29 29 29 29 29 29 29 30 153 157 157 154 155 37 144 145 146 44 38 462 442 464 36 37 82 83 84 
137 138 37 37 28 29 29 171 172 173 29 29 30 180 184 184 184 182 37 18 22 20 17 38 462 463 464 36 37 136 137 138 
181 182 37 37 28 29 29 198 199 200 29 29 30 153 157 157 154 155 37 45 49 47 44 38 462 442 464 36 37 18 19 20 
284 209 37 37 28 29 29 225 226 227 29 29 30 207 211 211 285 209 37 72 76 74 17 38 462 463 464 36 37 45 46 47 
37 37 37 37 28 29 29 29 29 29 29 29 30 37 37 37 37 37 37 45 49 47 98 38 462 442 464 36 37 99 284 101 
37 37 37 37 28 29 29 29 29 29 29 29 30 37 37 37 37 37 37 99 285 101 37 38 462 463 464 36 37 37 37 37 
37 37 37 37 37 56 56 56 56 56 56 56 37 90 91 91 91 91 92 37 37 37 37 38 462 442 464 36 37 37 37 37

0 0 0 0 0 0 334 0 0 0 334 0 0 0 0 0 0 0 0 0 0 0 0 0 0 0 0 0 0 0 0 0 
0 0 0 0 0 0 0 0 248 0 0 0 0 0 0 0 233 0 0 0 0 0 233 0 0 0 0 0 0 0 0 0 
0 0 0 0 363 363 363 0 252 0 0 0 0 0 0 0 287 0 0 0 0 0 287 0 334 0 0 0 0 0 0 0 
0 0 307 336 390 390 390 336 384 0 0 0 0 0 334 0 0 0 0 0 0 0 0 0 0 0 0 0 334 0 0 0 
0 0 0 336 256 0 256 336 0 0 0 0 0 0 0 0 0 0 0 0 0 0 0 0 0 0 0 0 0 0 0 0 
0 0 0 0 0 0 0 0 0 0 0 0 0 0 0 0 233 0 0 0 0 0 233 0 444 0 444 0 444 335 253 0 
0 0 0 0 0 450 0 401 0 335 0 0 0 0 444 0 287 0 0 0 0 0 287 0 471 0 471 0 471 0 252 0 
0 0 0 0 0 477 0 428 0 0 0 444 0 154 471 0 0 0 0 0 0 0 306 329 330 331 332 329 330 331 0 0 
0 0 0 0 0 0 0 0 0 0 0 471 0 472 0 234 0 0 0 0 0 0 0 305 301 292 0 292 277 278 0 0 
0 0 412 0 0 0 0 0 0 279 0 472 0 288 0 288 0 0 0 0 0 0 0 0 0 0 0 0 0 0 0 0 
0 0 192 0 0 0 0 0 0 0 0 0 0 0 0 0 0 0 0 0 0 0 0 0 0 0 0 0 0 0 0 0 
0 0 0 0 0 0 0 0 0 0 0 0 0 0 0 0 0 0 0 0 0 0 0 0 0 0 0 0 0 0 0 0 
0 0 0 0 0 0 0 0 0 0 0 0 0 0 0 0 0 0 0 0 0 0 0 0 0 0 0 0 0 0 0 0 
0 0 0 0 0 0 0 0 0 0 0 0 0 0 0 0 0 0 0 0 0 0 0 0 0 0 0 0 0 0 0 0 
0 410 0 0 0 0 0 0 0 0 0 0 0 0 0 0 0 0 0 0 0 0 0 0 0 0 0 0 0 0 0 0 
0 192 82 83 83 84 82 83 83 84 233 0 165 90 91 91 0 0 0 0 0 234 0 166 0 0 0 0 0 0 0 0 
0 0 0 0 0 0 0 0 0 0 287 0 192 0 0 0 0 0 384 384 385 288 0 193 0 0 0 0 0 0 0 0 
0 0 0 0 0 0 0 0 0 0 0 0 0 0 0 0 129 128 315 0 190 0 0 0 0 0 0 0 234 284 391 335 
0 0 0 0 0 0 0 444 444 0 253 0 328 0 0 0 311 257 342 186 190 0 0 0 0 0 0 0 288 0 251 0 
0 0 417 0 256 224 417 471 471 417 252 0 0 126 127 128 0 0 0 244 190 0 0 0 0 0 0 0 0 0 0 0 
0 0 0 0 0 0 417 256 0 224 0 0 0 251 0 417 384 384 384 384 385 0 0 166 0 0 0 0 0 0 0 0 
0 0 233 0 0 0 0 0 0 0 0 0 0 0 0 0 0 0 0 0 0 0 0 193 0 0 0 0 0 0 0 0 
0 0 287 0 0 0 0 0 0 0 0 0 0 0 0 0 0 0 0 0 0 0 0 0 0 0 0 0 234 0 335 0 
0 0 0 0 1 233 0 0 0 0 0 233 3 0 0 0 0 0 0 0 0 119 151 0 0 0 0 0 288 251 417 0 
0 0 0 0 0 260 0 382 0 382 0 260 0 0 444 0 444 0 0 0 0 0 0 0 0 0 0 0 0 0 0 0 
0 0 0 0 0 0 0 0 0 0 0 0 0 0 471 0 471 0 0 0 0 0 336 166 0 0 0 0 0 0 334 0 
0 0 0 0 0 355 0 0 0 0 0 328 0 0 445 0 445 335 0 0 363 335 0 193 0 0 0 0 0 0 0 0 
127 128 0 0 0 0 0 0 231 0 0 0 0 0 0 0 0 0 0 0 390 0 336 0 0 0 0 0 234 363 363 363 
0 417 0 0 0 355 0 0 0 0 0 328 0 0 417 224 0 0 0 0 364 335 0 0 0 0 0 0 288 390 390 390 
0 251 0 0 0 233 0 0 0 0 0 233 0 0 0 0 0 0 0 0 0 0 336 0 0 0 0 0 0 336 0 251 
0 0 0 0 0 260 0 382 0 382 0 260 0 0 37 0 0 0 0 0 0 224 0 166 0 0 0 0 0 368 0 0 
0 0 0 0 55 0 0 0 0 0 0 0 57 0 0 0 0 0 0 0 0 0 0 193 0 0 0 0 0 0 0 0

0 0 0 0 0 0 0 0 0 0 0 0 0 0 0 0 0 0 0 0 0 0 0 0 0 0 0 0 0 0 0 0 
0 0 0 0 0 0 0 0 0 0 0 0 0 0 0 0 0 0 0 0 0 0 0 0 0 0 0 0 0 0 0 0 
0 0 0 0 0 0 0 0 0 0 0 0 0 0 0 0 0 0 0 0 0 0 0 0 0 0 0 0 0 0 0 0 
0 0 0 0 0 0 0 0 0 0 0 0 0 0 0 0 0 0 0 0 0 0 0 0 0 0 0 0 0 0 0 0 
0 0 0 0 0 0 0 0 0 0 0 0 0 0 0 0 0 0 0 0 0 0 0 0 0 0 0 0 0 0 0 0 
0 0 0 0 0 0 0 0 0 0 0 0 0 0 0 0 0 0 0 0 0 0 0 0 0 0 0 0 0 0 218 219 
0 0 0 0 0 0 0 0 0 0 0 0 0 0 0 0 0 0 0 0 0 0 0 0 0 0 0 0 0 0 0 0 
0 0 0 0 0 0 0 0 0 0 0 0 0 0 0 0 0 0 0 0 0 0 0 0 0 0 0 0 0 0 0 0 
0 0 0 0 0 0 0 0 0 0 0 0 0 234 0 0 0 0 0 0 0 0 0 0 0 0 0 0 0 0 0 0 
0 0 0 0 0 0 0 0 0 0 0 0 0 0 0 0 0 168 0 0 0 0 0 0 0 0 0 0 0 0 0 0 
0 0 0 0 0 0 0 0 0 0 0 0 0 0 0 0 0 195 0 0 0 0 0 0 0 0 0 0 0 0 0 0 
0 0 0 0 0 0 0 0 0 0 0 0 0 0 0 0 0 0 0 0 0 0 0 0 0 0 0 0 0 0 0 0 
0 0 0 0 0 0 0 0 0 0 0 0 0 0 0 0 0 0 0 0 0 0 0 0 0 0 0 0 0 0 0 0 
0 0 0 0 0 0 0 0 0 0 0 0 0 0 0 0 0 0 0 0 0 0 0 168 0 0 0 167 0 0 0 82 
0 0 0 0 0 0 0 0 0 0 0 0 0 0 0 0 0 0 0 0 0 0 0 195 0 0 0 194 0 0 0 0 
0 0 0 0 0 0 0 0 0 0 0 0 0 0 0 0 0 0 0 0 0 0 0 0 0 0 0 165 0 0 0 0 
0 0 0 0 0 0 0 0 0 0 0 0 0 0 0 0 0 0 0 0 0 0 0 0 0 0 0 192 0 0 0 0 
0 0 0 0 0 0 0 0 0 0 0 0 0 0 0 0 0 0 0 0 0 0 0 0 0 0 0 0 0 0 0 0 
0 0 0 0 0 0 0 0 0 0 0 0 0 0 0 0 0 0 0 0 0 0 0 0 0 0 0 0 0 0 0 0 
0 0 0 0 0 0 0 0 0 0 0 0 0 0 0 0 0 0 0 0 0 0 0 0 0 0 0 0 0 0 0 0 
0 0 0 0 0 0 0 0 0 0 0 0 0 0 0 0 0 0 0 0 0 0 0 0 0 0 0 165 0 0 0 0 
0 0 0 0 0 0 0 0 0 0 0 0 0 0 0 0 0 0 0 0 0 0 0 0 0 0 0 192 0 0 0 0 
0 0 0 0 170 0 0 0 0 0 0 0 170 82 83 83 83 84 0 90 91 92 97 0 0 0 0 0 0 0 0 0 
0 0 0 0 197 0 0 0 0 0 0 0 197 0 0 0 0 0 247 0 0 0 0 0 0 0 0 0 0 0 0 0 
0 0 0 0 0 0 0 0 0 0 0 0 0 0 0 0 0 0 0 0 0 0 0 0 0 0 0 0 0 0 0 0 
0 0 0 0 0 0 0 0 0 0 0 0 0 0 0 0 0 0 245 0 0 0 0 0 0 0 0 165 0 0 0 0 
0 0 0 0 0 0 0 0 0 0 0 0 0 0 0 0 0 0 0 0 0 0 0 0 0 0 0 192 0 0 0 0 
0 0 0 0 0 0 0 0 0 0 0 0 0 0 0 0 0 0 0 0 0 0 0 0 0 0 0 0 0 0 0 0 
0 0 0 0 0 0 0 0 0 0 0 0 0 0 0 0 0 0 0 0 0 0 0 0 0 0 0 0 0 0 0 0 
0 0 0 0 0 0 0 0 0 0 0 0 0 0 0 0 0 0 0 0 0 0 0 0 0 0 0 0 0 314 0 0 
0 0 0 0 170 0 0 0 0 0 0 0 170 0 0 0 0 0 0 0 0 0 0 0 0 0 0 165 0 0 0 0 
0 0 0 0 197 0 0 0 0 0 0 0 197 0 0 0 0 0 0 0 0 0 0 0 0 0 0 192 0 0 0 0

0 0 0 1 1 1 1 1 0 1 1 1 1 1 1 1 0 0 0 0 0 0 0 0 0 0 0 0 0 0 0 0 
0 0 0 1 1 1 1 1 0 1 1 1 1 1 1 1 0 0 0 0 0 0 0 0 0 0 0 0 0 0 0 0 
0 0 0 1 1 1 1 1 1 1 1 1 1 1 1 1 1 0 0 0 0 0 1 1 1 1 1 1 1 1 0 0 
0 0 1 1 1 1 1 1 1 1 1 1 1 1 1 1 0 0 0 0 0 0 0 1 1 1 1 1 1 1 0 0 
0 0 0 1 1 0 1 1 0 1 1 1 1 1 1 1 0 0 0 0 0 0 0 1 1 1 1 1 1 1 0 0 
0 0 0 0 0 0 0 0 0 1 1 1 1 1 1 1 0 0 0 0 0 0 0 1 1 1 1 1 1 1 1 0 
0 0 0 0 0 1 0 1 0 1 1 1 1 1 1 1 1 0 0 0 0 0 1 1 1 1 1 1 1 1 1 0 
0 0 0 0 0 1 0 1 0 1 1 1 1 1 1 1 0 0 0 0 0 0 1 1 1 1 0 1 1 1 0 0 
0 0 0 0 0 0 0 0 0 1 1 1 1 1 0 1 0 0 0 0 0 0 0 1 1 1 0 1 1 1 0 0 
0 0 0 0 0 0 0 0 0 1 1 1 1 1 0 1 0 0 0 0 0 0 0 0 0 0 0 0 0 0 0 0 
0 0 1 0 0 0 0 0 0 0 0 0 0 0 0 0 0 1 0 0 0 0 0 0 0 0 0 0 0 0 0 0 
0 0 0 0 0 0 0 0 0 0 0 0 0 0 0 0 0 0 0 0 0 0 0 0 0 0 0 0 0 0 0 0 
0 0 0 0 0 0 0 0 0 0 0 0 0 0 0 0 0 0 0 0 0 0 0 0 0 0 0 0 0 0 0 0 
0 0 0 0 0 0 0 0 0 0 0 0 0 0 0 0 0 0 0 0 0 0 0 0 0 0 0 0 0 0 0 0 
0 0 0 0 0 0 0 0 0 0 0 0 0 0 0 0 0 0 0 0 0 0 0 1 0 0 0 1 1 1 1 1 
0 1 1 1 1 1 1 1 1 1 0 0 1 1 1 1 1 1 0 0 0 0 0 0 0 0 0 0 1 1 1 1 
0 0 1 0 0 0 0 0 0 1 1 0 1 1 1 1 1 1 1 1 1 1 0 1 0 0 0 1 1 1 1 1 
0 0 1 0 0 0 0 0 0 1 0 0 0 1 1 1 1 1 0 0 1 0 0 0 0 0 0 0 1 0 1 1 
0 0 1 0 0 0 0 0 0 1 1 0 1 1 1 1 1 1 0 0 1 0 0 0 0 0 0 0 1 0 1 1 
0 0 1 0 1 1 1 0 0 1 1 0 0 1 1 1 0 0 0 0 1 0 0 0 0 0 0 0 0 0 0 0 
0 0 0 0 0 0 1 1 0 1 0 0 0 1 0 1 1 1 1 1 1 0 0 0 0 0 0 0 0 0 1 1 
0 0 0 0 0 0 0 0 0 0 0 0 0 0 0 0 0 0 0 0 0 0 0 1 0 0 0 1 0 1 1 1 
0 0 1 0 0 0 0 0 0 0 0 0 0 0 0 0 0 0 0 0 0 0 0 0 0 0 0 0 0 1 1 1 
0 0 0 0 1 0 0 0 0 0 0 0 1 1 1 1 1 1 0 1 1 1 1 0 0 0 0 0 1 1 1 0 
1 1 0 0 0 1 0 1 0 1 0 1 0 1 0 0 0 1 0 1 0 0 1 0 0 0 0 0 0 0 0 0 
0 1 0 0 0 0 0 0 0 0 0 0 0 1 0 0 0 1 0 1 0 0 1 0 0 0 0 0 0 1 1 1 
0 1 0 0 0 1 0 1 1 1 0 1 0 1 0 0 0 1 0 1 0 0 1 1 0 0 0 1 0 1 1 1 
1 1 0 0 0 0 0 1 1 1 0 0 0 1 0 0 1 1 0 1 0 0 1 0 0 0 0 0 0 1 1 1 
1 1 0 0 0 1 0 1 1 1 0 1 0 1 1 1 0 1 0 1 0 0 1 0 0 0 0 0 1 1 1 1 
0 1 0 0 0 0 0 0 0 0 0 0 0 0 0 0 0 0 0 1 0 1 1 0 0 0 0 0 0 1 0 1 
0 0 0 0 0 1 0 1 0 1 0 1 0 0 0 0 0 0 0 1 0 1 0 0 0 0 0 0 0 1 0 0 
0 0 0 0 1 0 0 0 0 0 0 0 1 1 1 1 1 1 1 0 0 0 0 1 0 0 0 1 0 0 0 0
