images\roguelikeSheet_transparent.png 16 57 32
20 20 

0 0 0 0 0 0 0 0 0 0 0 0 0 0 0 0 0 0 0 0 
0 0 0 0 0 0 0 0 0 0 0 0 0 0 0 0 0 0 0 0 
0 0 0 0 0 0 0 0 0 0 0 0 0 0 0 0 0 0 0 0 
0 0 722 720 720 720 720 720 720 720 720 720 720 720 720 720 720 723 0 0 
0 0 778 1279 1280 1280 1280 1280 1280 1280 1280 1280 1280 1280 1280 1280 1281 778 0 0 
0 0 778 1336 1337 1337 1337 1337 1337 1337 1337 1337 1337 1337 1337 1337 1338 778 0 0 
0 0 778 123 123 123 123 123 123 123 123 123 123 123 123 123 123 778 0 0 
0 0 778 123 123 123 123 123 123 123 123 123 123 123 123 123 123 778 0 0 
0 0 724 720 720 720 723 123 123 123 123 123 123 722 720 720 720 781 0 0 
0 0 778 1280 1280 1280 778 123 123 123 123 123 123 778 1280 1280 1280 778 0 0 
0 0 778 1337 1337 1337 778 123 123 123 123 123 123 778 1337 1337 1337 778 0 0 
0 0 778 123 123 123 833 123 123 123 123 123 123 833 123 123 123 778 0 0 
0 0 778 123 123 123 1390 123 123 123 123 123 123 1390 123 123 123 778 0 0 
0 0 778 123 123 123 1390 123 123 123 123 123 123 1390 123 123 123 778 0 0 
0 0 778 123 123 123 123 123 123 123 123 123 123 123 123 123 123 778 0 0 
0 0 778 123 123 123 123 123 123 123 123 123 123 123 123 123 123 778 0 0 
0 0 778 123 123 123 123 123 123 123 123 123 123 123 123 123 123 778 0 0 
0 0 778 123 123 123 123 123 123 123 123 123 123 123 123 123 123 778 0 0 
0 0 779 720 720 720 720 720 723 123 123 722 720 720 720 720 720 780 0 0 
0 0 0 0 0 0 0 0 0 0 0 0 0 0 0 0 0 0 0 0

0 0 0 0 0 0 0 0 0 0 0 0 0 0 0 0 0 0 0 0 
0 0 0 0 0 0 0 0 0 0 0 0 0 0 0 0 0 0 0 0 
0 0 0 0 0 0 0 0 0 0 0 0 0 0 0 0 0 0 0 0 
0 0 0 0 0 0 0 0 0 0 0 0 0 0 0 0 0 0 0 0 
0 0 0 200 143 333 85 0 601 0 0 602 0 0 333 0 0 0 0 0 
0 0 0 257 310 310 369 0 0 0 0 0 731 733 847 847 848 0 0 0 
0 0 0 139 0 0 0 0 0 0 0 0 0 0 0 0 0 0 0 0 
0 0 0 139 0 0 0 0 0 0 0 0 0 0 0 0 0 0 0 0 
0 0 0 0 0 0 0 0 0 0 0 0 0 0 0 0 0 0 0 0 
0 0 0 0 483 0 0 0 0 0 0 0 0 0 0 483 0 0 0 0 
0 0 0 0 0 0 0 0 0 0 0 0 0 0 0 0 0 0 0 0 
0 0 0 0 191 0 0 0 0 0 0 0 0 0 0 191 0 0 0 0 
0 0 0 198 199 313 0 0 0 0 0 0 0 0 198 199 313 0 0 0 
0 0 0 923 924 925 0 0 0 0 0 0 0 0 1265 1266 1267 0 0 0 
0 0 0 980 981 982 20 0 0 0 0 0 0 20 1322 1323 1324 0 0 0 
0 0 0 1037 1038 1039 0 0 0 0 0 0 0 0 1379 1380 1381 0 0 0 
0 0 0 0 0 0 0 0 0 0 0 0 0 0 0 0 0 0 0 0 
0 0 0 0 0 0 0 0 0 0 0 0 0 0 0 0 0 0 0 0 
0 0 0 0 0 0 0 0 0 1094 1096 0 0 0 0 0 0 0 0 0 
0 0 0 0 0 0 0 0 0 0 0 0 0 0 0 0 0 0 0 0

0 0 0 0 0 0 0 0 0 0 0 0 0 0 0 0 0 0 0 0 
0 0 0 0 0 0 0 0 0 0 0 0 0 0 0 0 0 0 0 0 
0 0 0 0 0 0 0 0 0 0 0 0 0 0 0 0 0 0 0 0 
0 0 0 0 0 0 0 0 0 0 0 0 0 0 0 0 0 0 0 0 
0 0 0 0 0 0 0 0 0 0 0 0 0 0 0 0 0 0 0 0 
0 0 0 0 0 0 0 0 0 0 0 0 0 0 0 0 0 0 0 0 
0 0 0 0 0 0 0 0 0 0 0 0 0 0 0 0 0 0 0 0 
0 0 0 0 0 0 0 0 0 0 0 0 0 0 0 0 0 0 0 0 
0 0 0 0 0 0 0 0 0 0 0 0 0 0 0 0 0 0 0 0 
0 0 0 0 0 0 0 0 0 0 0 0 0 0 0 0 0 0 0 0 
0 0 0 0 0 0 0 0 0 0 0 0 0 0 0 0 0 0 0 0 
0 0 0 0 0 0 0 0 0 0 0 0 0 0 0 0 0 0 0 0 
0 0 0 0 907 419 0 0 0 0 0 0 0 0 0 906 419 0 0 0 
0 0 0 0 0 0 0 0 0 0 0 0 0 0 0 0 0 0 0 0 
0 0 0 0 0 0 0 0 0 0 0 0 0 0 0 0 0 0 0 0 
0 0 0 0 0 0 0 0 0 0 0 0 0 0 0 0 0 0 0 0 
0 0 0 0 0 0 0 0 0 0 0 0 0 0 0 0 0 0 0 0 
0 0 0 0 0 0 0 0 0 0 0 0 0 0 0 0 0 0 0 0 
0 0 0 0 0 0 0 0 0 0 0 0 0 0 0 0 0 0 0 0 
0 0 0 0 0 0 0 0 0 0 0 0 0 0 0 0 0 0 0 0

0 0 0 0 0 0 0 0 0 0 0 0 0 0 0 0 0 0 0 0 
0 0 0 0 0 0 0 0 0 0 0 0 0 0 0 0 0 0 0 0 
0 0 0 0 0 0 0 0 0 0 0 0 0 0 0 0 0 0 0 0 
0 0 0 0 0 0 0 0 0 0 0 0 0 0 0 0 0 1 0 0 
0 0 0 0 0 0 0 0 0 0 0 0 0 0 0 0 0 1 0 0 
0 0 0 1 1 1 1 1 1 1 1 1 1 1 1 1 1 1 0 0 
0 0 0 1 0 0 0 0 0 0 0 0 0 0 0 0 0 1 0 0 
0 0 0 1 0 0 0 0 0 0 0 0 0 0 0 0 0 1 0 0 
0 0 1 1 1 1 1 0 0 0 0 0 0 1 1 1 1 1 0 0 
0 0 1 0 0 0 1 0 0 0 0 0 0 1 0 0 0 0 0 0 
0 0 1 0 0 0 1 0 0 0 0 0 0 1 0 0 0 0 0 0 
0 0 1 0 0 0 1 0 0 0 0 0 0 1 0 0 0 0 0 0 
0 0 1 1 1 1 1 0 0 0 0 0 0 1 1 1 1 1 0 0 
0 0 1 0 0 0 1 0 0 0 0 0 0 1 0 0 0 1 0 0 
0 0 1 0 0 0 1 0 0 0 0 0 0 1 0 0 0 1 0 0 
0 0 1 0 0 0 0 0 0 0 0 0 0 0 0 0 0 1 0 0 
0 0 1 0 0 0 0 0 0 0 0 0 0 0 0 0 0 1 0 0 
0 0 1 0 0 0 0 0 0 0 0 0 0 0 0 0 0 1 0 0 
0 0 1 1 1 1 1 1 1 0 0 1 1 1 1 1 1 1 0 0 
0 0 0 0 0 0 0 0 0 1 1 0 0 0 0 0 0 0 0 0
